"filename", "language", "HTML", "TypeScript", "CSS", "SCSS", "comment", "blank", "total"
"c:\Users\44421\Desktop\sveikataAPI-master\sveikata\ClientApp\src\app\adminPages\AddExerciseToPlan\AddExerciseToPlan.component.html", "HTML", 40, 0, 0, 0, 1, 2, 43
"c:\Users\44421\Desktop\sveikataAPI-master\sveikata\ClientApp\src\app\adminPages\AddExerciseToPlan\AddExerciseToPlan.component.scss", "SCSS", 0, 0, 0, 13, 0, 0, 13
"c:\Users\44421\Desktop\sveikataAPI-master\sveikata\ClientApp\src\app\adminPages\AddExerciseToPlan\AddExerciseToPlan.component.ts", "TypeScript", 0, 101, 0, 0, 2, 14, 117
"c:\Users\44421\Desktop\sveikataAPI-master\sveikata\ClientApp\src\app\adminPages\AddExercise\AddExercise.component.html", "HTML", 46, 0, 0, 0, 11, 2, 59
"c:\Users\44421\Desktop\sveikataAPI-master\sveikata\ClientApp\src\app\adminPages\AddExercise\AddExercise.component.scss", "SCSS", 0, 0, 0, 13, 0, 1, 14
"c:\Users\44421\Desktop\sveikataAPI-master\sveikata\ClientApp\src\app\adminPages\AddExercise\AddExercise.component.ts", "TypeScript", 0, 107, 0, 0, 0, 17, 124
"c:\Users\44421\Desktop\sveikataAPI-master\sveikata\ClientApp\src\app\adminPages\AddPlan\AddPlan.component.html", "HTML", 65, 0, 0, 0, 15, 2, 82
"c:\Users\44421\Desktop\sveikataAPI-master\sveikata\ClientApp\src\app\adminPages\AddPlan\AddPlan.component.scss", "SCSS", 0, 0, 0, 41, 1, 7, 49
"c:\Users\44421\Desktop\sveikataAPI-master\sveikata\ClientApp\src\app\adminPages\AddPlan\AddPlan.component.ts", "TypeScript", 0, 130, 0, 0, 0, 19, 149
"c:\Users\44421\Desktop\sveikataAPI-master\sveikata\ClientApp\src\app\adminPages\Bookmarks\Bookmarks.component.html", "HTML", 27, 0, 0, 0, 2, 2, 31
"c:\Users\44421\Desktop\sveikataAPI-master\sveikata\ClientApp\src\app\adminPages\Bookmarks\Bookmarks.component.scss", "SCSS", 0, 0, 0, 13, 0, 1, 14
"c:\Users\44421\Desktop\sveikataAPI-master\sveikata\ClientApp\src\app\adminPages\Bookmarks\Bookmarks.component.ts", "TypeScript", 0, 34, 0, 0, 0, 7, 41
"c:\Users\44421\Desktop\sveikataAPI-master\sveikata\ClientApp\src\app\adminPages\Dashboard\AdminDashboard.component.html", "HTML", 7, 0, 0, 0, 13, 2, 22
"c:\Users\44421\Desktop\sveikataAPI-master\sveikata\ClientApp\src\app\adminPages\Dashboard\AdminDashboard.component.scss", "SCSS", 0, 0, 0, 13, 0, 1, 14
"c:\Users\44421\Desktop\sveikataAPI-master\sveikata\ClientApp\src\app\adminPages\Dashboard\AdminDashboard.component.ts", "TypeScript", 0, 60, 0, 0, 0, 8, 68
"c:\Users\44421\Desktop\sveikataAPI-master\sveikata\ClientApp\src\app\adminPages\Messages\Messages.component.html", "HTML", 64, 0, 0, 0, 15, 2, 81
"c:\Users\44421\Desktop\sveikataAPI-master\sveikata\ClientApp\src\app\adminPages\Messages\Messages.component.scss", "SCSS", 0, 0, 0, 13, 0, 1, 14
"c:\Users\44421\Desktop\sveikataAPI-master\sveikata\ClientApp\src\app\adminPages\Messages\Messages.component.ts", "TypeScript", 0, 73, 0, 0, 0, 13, 86
"c:\Users\44421\Desktop\sveikataAPI-master\sveikata\ClientApp\src\app\adminPages\Profile\Profile.component.html", "HTML", 76, 0, 0, 0, 6, 2, 84
"c:\Users\44421\Desktop\sveikataAPI-master\sveikata\ClientApp\src\app\adminPages\Profile\Profile.component.scss", "SCSS", 0, 0, 0, 13, 0, 1, 14
"c:\Users\44421\Desktop\sveikataAPI-master\sveikata\ClientApp\src\app\adminPages\Profile\Profile.component.ts", "TypeScript", 0, 92, 0, 0, 0, 13, 105
"c:\Users\44421\Desktop\sveikataAPI-master\sveikata\ClientApp\src\app\adminPages\Reviews\Reviews.component.html", "HTML", 26, 0, 0, 0, 0, 2, 28
"c:\Users\44421\Desktop\sveikataAPI-master\sveikata\ClientApp\src\app\adminPages\Reviews\Reviews.component.scss", "SCSS", 0, 0, 0, 13, 0, 1, 14
"c:\Users\44421\Desktop\sveikataAPI-master\sveikata\ClientApp\src\app\adminPages\Reviews\Reviews.component.ts", "TypeScript", 0, 34, 0, 0, 0, 6, 40
"c:\Users\44421\Desktop\sveikataAPI-master\sveikata\ClientApp\src\app\adminPages\ShowExercises\ShowExercises.component.html", "HTML", 27, 0, 0, 0, 1, 2, 30
"c:\Users\44421\Desktop\sveikataAPI-master\sveikata\ClientApp\src\app\adminPages\ShowExercises\ShowExercises.component.scss", "SCSS", 0, 0, 0, 13, 0, 1, 14
"c:\Users\44421\Desktop\sveikataAPI-master\sveikata\ClientApp\src\app\adminPages\ShowExercises\ShowExercises.component.ts", "TypeScript", 0, 34, 0, 0, 0, 6, 40
"c:\Users\44421\Desktop\sveikataAPI-master\sveikata\ClientApp\src\app\adminPages\ShowPlans\ShowPlans.component.html", "HTML", 32, 0, 0, 0, 1, 2, 35
"c:\Users\44421\Desktop\sveikataAPI-master\sveikata\ClientApp\src\app\adminPages\ShowPlans\ShowPlans.component.scss", "SCSS", 0, 0, 0, 13, 0, 1, 14
"c:\Users\44421\Desktop\sveikataAPI-master\sveikata\ClientApp\src\app\adminPages\ShowPlans\ShowPlans.component.ts", "TypeScript", 0, 37, 0, 0, 0, 6, 43
"c:\Users\44421\Desktop\sveikataAPI-master\sveikata\ClientApp\src\app\adminPages\ShowUsers\ShowUsers.component.html", "HTML", 61, 0, 0, 0, 0, 3, 64
"c:\Users\44421\Desktop\sveikataAPI-master\sveikata\ClientApp\src\app\adminPages\ShowUsers\ShowUsers.component.scss", "SCSS", 0, 0, 0, 13, 0, 1, 14
"c:\Users\44421\Desktop\sveikataAPI-master\sveikata\ClientApp\src\app\adminPages\ShowUsers\ShowUsers.component.ts", "TypeScript", 0, 57, 0, 0, 0, 13, 70
"c:\Users\44421\Desktop\sveikataAPI-master\sveikata\ClientApp\src\app\adminPages\UserProfile\UserProfile.component.html", "HTML", 71, 0, 0, 0, 2, 0, 73
"c:\Users\44421\Desktop\sveikataAPI-master\sveikata\ClientApp\src\app\adminPages\UserProfile\UserProfile.component.scss", "SCSS", 0, 0, 0, 13, 0, 1, 14
"c:\Users\44421\Desktop\sveikataAPI-master\sveikata\ClientApp\src\app\adminPages\UserProfile\UserProfile.component.ts", "TypeScript", 0, 60, 0, 0, 0, 10, 70
"c:\Users\44421\Desktop\sveikataAPI-master\sveikata\ClientApp\src\app\adminPages\admin.module.ts", "TypeScript", 0, 35, 0, 0, 39, 3, 77
"c:\Users\44421\Desktop\sveikataAPI-master\sveikata\ClientApp\src\app\adminPages\admin.routing.ts", "TypeScript", 0, 73, 0, 0, 0, 3, 76
"c:\Users\44421\Desktop\sveikataAPI-master\sveikata\ClientApp\src\app\app.component.css", "CSS", 0, 0, 0, 0, 0, 1, 1
"c:\Users\44421\Desktop\sveikataAPI-master\sveikata\ClientApp\src\app\app.component.html", "HTML", 1, 0, 0, 0, 0, 2, 3
"c:\Users\44421\Desktop\sveikataAPI-master\sveikata\ClientApp\src\app\app.component.spec.ts", "TypeScript", 0, 27, 0, 0, 0, 1, 28
"c:\Users\44421\Desktop\sveikataAPI-master\sveikata\ClientApp\src\app\app.component.ts", "TypeScript", 0, 19, 0, 0, 0, 3, 22
"c:\Users\44421\Desktop\sveikataAPI-master\sveikata\ClientApp\src\app\app.module.ts", "TypeScript", 0, 30, 0, 0, 47, 5, 82
"c:\Users\44421\Desktop\sveikataAPI-master\sveikata\ClientApp\src\app\app.routing.ts", "TypeScript", 0, 39, 0, 0, 0, 3, 42
"c:\Users\44421\Desktop\sveikataAPI-master\sveikata\ClientApp\src\app\core\AdminHeader\AdminHeader.component.html", "HTML", 47, 0, 0, 0, 0, 2, 49
"c:\Users\44421\Desktop\sveikataAPI-master\sveikata\ClientApp\src\app\core\AdminHeader\AdminHeader.component.scss", "SCSS", 0, 0, 0, 13, 0, 1, 14
"c:\Users\44421\Desktop\sveikataAPI-master\sveikata\ClientApp\src\app\core\AdminHeader\AdminHeader.component.ts", "TypeScript", 0, 40, 0, 0, 0, 8, 48
"c:\Users\44421\Desktop\sveikataAPI-master\sveikata\ClientApp\src\app\core\AdminHeader\admin-menu-items.ts", "TypeScript", 0, 57, 0, 0, 0, 5, 62
"c:\Users\44421\Desktop\sveikataAPI-master\sveikata\ClientApp\src\app\core\AdminSidebar\AdminSidebar.component.html", "HTML", 31, 0, 0, 0, 0, 2, 33
"c:\Users\44421\Desktop\sveikataAPI-master\sveikata\ClientApp\src\app\core\AdminSidebar\AdminSidebar.component.scss", "SCSS", 0, 0, 0, 13, 0, 1, 14
"c:\Users\44421\Desktop\sveikataAPI-master\sveikata\ClientApp\src\app\core\AdminSidebar\AdminSidebar.component.ts", "TypeScript", 0, 39, 0, 0, 2, 8, 49
"c:\Users\44421\Desktop\sveikataAPI-master\sveikata\ClientApp\src\app\core\Footer\Footer.component.html", "HTML", 16, 0, 0, 0, 2, 2, 20
"c:\Users\44421\Desktop\sveikataAPI-master\sveikata\ClientApp\src\app\core\Footer\Footer.component.scss", "SCSS", 0, 0, 0, 13, 0, 1, 14
"c:\Users\44421\Desktop\sveikataAPI-master\sveikata\ClientApp\src\app\core\Footer\Footer.component.ts", "TypeScript", 0, 8, 0, 0, 0, 2, 10
"c:\Users\44421\Desktop\sveikataAPI-master\sveikata\ClientApp\src\app\core\Header\Header.component.html", "HTML", 36, 0, 0, 0, 0, 2, 38
"c:\Users\44421\Desktop\sveikataAPI-master\sveikata\ClientApp\src\app\core\Header\Header.component.scss", "SCSS", 0, 0, 0, 13, 0, 1, 14
"c:\Users\44421\Desktop\sveikataAPI-master\sveikata\ClientApp\src\app\core\Header\Header.component.ts", "TypeScript", 0, 28, 0, 0, 0, 9, 37
"c:\Users\44421\Desktop\sveikataAPI-master\sveikata\ClientApp\src\app\core\Menu\Menu.component.html", "HTML", 19, 0, 0, 0, 0, 0, 19
"c:\Users\44421\Desktop\sveikataAPI-master\sveikata\ClientApp\src\app\core\Menu\Menu.component.scss", "SCSS", 0, 0, 0, 13, 0, 1, 14
"c:\Users\44421\Desktop\sveikataAPI-master\sveikata\ClientApp\src\app\core\Menu\Menu.component.ts", "TypeScript", 0, 46, 0, 0, 0, 8, 54
"c:\Users\44421\Desktop\sveikataAPI-master\sveikata\ClientApp\src\app\core\Menu\menu-items.ts", "TypeScript", 0, 32, 0, 0, 0, 5, 37
"c:\Users\44421\Desktop\sveikataAPI-master\sveikata\ClientApp\src\app\core\SignInPopup\SignIn.component.html", "HTML", 68, 0, 0, 0, 3, 17, 88
"c:\Users\44421\Desktop\sveikataAPI-master\sveikata\ClientApp\src\app\core\SignInPopup\SignIn.component.scss", "SCSS", 0, 0, 0, 13, 0, 1, 14
"c:\Users\44421\Desktop\sveikataAPI-master\sveikata\ClientApp\src\app\core\SignInPopup\SignIn.component.ts", "TypeScript", 0, 8, 0, 0, 0, 2, 10
"c:\Users\44421\Desktop\sveikataAPI-master\sveikata\ClientApp\src\app\dashboard\DashboardOne\DashboardOne.component.html", "HTML", 2, 0, 0, 0, 2, 2, 6
"c:\Users\44421\Desktop\sveikataAPI-master\sveikata\ClientApp\src\app\dashboard\DashboardOne\DashboardOne.component.scss", "SCSS", 0, 0, 0, 13, 0, 1, 14
"c:\Users\44421\Desktop\sveikataAPI-master\sveikata\ClientApp\src\app\dashboard\DashboardOne\DashboardOne.component.ts", "TypeScript", 0, 60, 0, 0, 0, 7, 67
"c:\Users\44421\Desktop\sveikataAPI-master\sveikata\ClientApp\src\app\dashboard\dashboard.module.ts", "TypeScript", 0, 17, 0, 0, 0, 4, 21
"c:\Users\44421\Desktop\sveikataAPI-master\sveikata\ClientApp\src\app\dashboard\dashboard.routing.ts", "TypeScript", 0, 11, 0, 0, 0, 3, 14
"c:\Users\44421\Desktop\sveikataAPI-master\sveikata\ClientApp\src\app\data\charts.data.ts", "TypeScript", 0, 26, 0, 0, 0, 1, 27
"c:\Users\44421\Desktop\sveikataAPI-master\sveikata\ClientApp\src\app\entities\comment.ts", "TypeScript", 0, 14, 0, 0, 0, 1, 15
"c:\Users\44421\Desktop\sveikataAPI-master\sveikata\ClientApp\src\app\entities\exercise.ts", "TypeScript", 0, 21, 0, 0, 0, 3, 24
"c:\Users\44421\Desktop\sveikataAPI-master\sveikata\ClientApp\src\app\entities\message.ts", "TypeScript", 0, 16, 0, 0, 0, 2, 18
"c:\Users\44421\Desktop\sveikataAPI-master\sveikata\ClientApp\src\app\entities\plan.ts", "TypeScript", 0, 21, 0, 0, 0, 2, 23
"c:\Users\44421\Desktop\sveikataAPI-master\sveikata\ClientApp\src\app\entities\post.ts", "TypeScript", 0, 12, 0, 0, 0, 1, 13
"c:\Users\44421\Desktop\sveikataAPI-master\sveikata\ClientApp\src\app\entities\review.ts", "TypeScript", 0, 26, 0, 0, 0, 1, 27
"c:\Users\44421\Desktop\sveikataAPI-master\sveikata\ClientApp\src\app\entities\user.ts", "TypeScript", 0, 29, 0, 0, 0, 1, 30
"c:\Users\44421\Desktop\sveikataAPI-master\sveikata\ClientApp\src\app\globalFrontendComponents\Banner\Banner.component.html", "HTML", 28, 0, 0, 0, 2, 2, 32
"c:\Users\44421\Desktop\sveikataAPI-master\sveikata\ClientApp\src\app\globalFrontendComponents\Banner\Banner.component.scss", "SCSS", 0, 0, 0, 13, 0, 1, 14
"c:\Users\44421\Desktop\sveikataAPI-master\sveikata\ClientApp\src\app\globalFrontendComponents\Banner\Banner.component.ts", "TypeScript", 0, 17, 0, 0, 3, 9, 29
"c:\Users\44421\Desktop\sveikataAPI-master\sveikata\ClientApp\src\app\globalFrontendComponents\FeatureGridSection\FeatureGridSection.component.html", "HTML", 44, 0, 0, 0, 1, 0, 45
"c:\Users\44421\Desktop\sveikataAPI-master\sveikata\ClientApp\src\app\globalFrontendComponents\FeatureGridSection\FeatureGridSection.component.scss", "SCSS", 0, 0, 0, 13, 0, 1, 14
"c:\Users\44421\Desktop\sveikataAPI-master\sveikata\ClientApp\src\app\globalFrontendComponents\FeatureGridSection\FeatureGridSection.component.ts", "TypeScript", 0, 17, 0, 0, 3, 9, 29
"c:\Users\44421\Desktop\sveikataAPI-master\sveikata\ClientApp\src\app\globalFrontendComponents\FeatureSection\FeatureSection.component.html", "HTML", 32, 0, 0, 0, 0, 0, 32
"c:\Users\44421\Desktop\sveikataAPI-master\sveikata\ClientApp\src\app\globalFrontendComponents\FeatureSection\FeatureSection.component.scss", "SCSS", 0, 0, 0, 13, 0, 1, 14
"c:\Users\44421\Desktop\sveikataAPI-master\sveikata\ClientApp\src\app\globalFrontendComponents\FeatureSection\FeatureSection.component.ts", "TypeScript", 0, 18, 0, 0, 4, 10, 32
"c:\Users\44421\Desktop\sveikataAPI-master\sveikata\ClientApp\src\app\globalFrontendComponents\ParallaxSection\Parallax.component.html", "HTML", 14, 0, 0, 0, 2, 1, 17
"c:\Users\44421\Desktop\sveikataAPI-master\sveikata\ClientApp\src\app\globalFrontendComponents\ParallaxSection\Parallax.component.scss", "SCSS", 0, 0, 0, 13, 0, 1, 14
"c:\Users\44421\Desktop\sveikataAPI-master\sveikata\ClientApp\src\app\globalFrontendComponents\ParallaxSection\Parallax.component.ts", "TypeScript", 0, 14, 0, 0, 0, 6, 20
"c:\Users\44421\Desktop\sveikataAPI-master\sveikata\ClientApp\src\app\globalFrontendComponents\PopuplarCategories\PopularCategories.component.html", "HTML", 31, 0, 0, 0, 3, 0, 34
"c:\Users\44421\Desktop\sveikataAPI-master\sveikata\ClientApp\src\app\globalFrontendComponents\PopuplarCategories\PopularCategories.component.scss", "SCSS", 0, 0, 0, 13, 0, 1, 14
"c:\Users\44421\Desktop\sveikataAPI-master\sveikata\ClientApp\src\app\globalFrontendComponents\PopuplarCategories\PopularCategories.component.ts", "TypeScript", 0, 47, 0, 0, 3, 10, 60
"c:\Users\44421\Desktop\sveikataAPI-master\sveikata\ClientApp\src\app\globalFrontendComponents\Services\Services.component.html", "HTML", 21, 0, 0, 0, 0, 2, 23
"c:\Users\44421\Desktop\sveikataAPI-master\sveikata\ClientApp\src\app\globalFrontendComponents\Services\Services.component.scss", "SCSS", 0, 0, 0, 13, 0, 1, 14
"c:\Users\44421\Desktop\sveikataAPI-master\sveikata\ClientApp\src\app\globalFrontendComponents\Services\Services.component.ts", "TypeScript", 0, 17, 0, 0, 3, 9, 29
"c:\Users\44421\Desktop\sveikataAPI-master\sveikata\ClientApp\src\app\globalFrontendComponents\SmallGallerySlider\SmallGallerySlider.component.html", "HTML", 8, 0, 0, 0, 0, 0, 8
"c:\Users\44421\Desktop\sveikataAPI-master\sveikata\ClientApp\src\app\globalFrontendComponents\SmallGallerySlider\SmallGallerySlider.component.scss", "SCSS", 0, 0, 0, 13, 0, 1, 14
"c:\Users\44421\Desktop\sveikataAPI-master\sveikata\ClientApp\src\app\globalFrontendComponents\SmallGallerySlider\SmallGallerySlider.component.ts", "TypeScript", 0, 44, 0, 0, 2, 15, 61
"c:\Users\44421\Desktop\sveikataAPI-master\sveikata\ClientApp\src\app\globalFrontendComponents\Team\Team.component.html", "HTML", 34, 0, 0, 0, 0, 0, 34
"c:\Users\44421\Desktop\sveikataAPI-master\sveikata\ClientApp\src\app\globalFrontendComponents\Team\Team.component.scss", "SCSS", 0, 0, 0, 13, 0, 1, 14
"c:\Users\44421\Desktop\sveikataAPI-master\sveikata\ClientApp\src\app\globalFrontendComponents\Team\Team.component.ts", "TypeScript", 0, 17, 0, 0, 3, 9, 29
"c:\Users\44421\Desktop\sveikataAPI-master\sveikata\ClientApp\src\app\globalFrontendComponents\Testimonial\Testimonial.component.html", "HTML", 22, 0, 0, 0, 4, 3, 29
"c:\Users\44421\Desktop\sveikataAPI-master\sveikata\ClientApp\src\app\globalFrontendComponents\Testimonial\Testimonial.component.scss", "SCSS", 0, 0, 0, 13, 0, 1, 14
"c:\Users\44421\Desktop\sveikataAPI-master\sveikata\ClientApp\src\app\globalFrontendComponents\Testimonial\Testimonial.component.ts", "TypeScript", 0, 41, 0, 0, 3, 10, 54
"c:\Users\44421\Desktop\sveikataAPI-master\sveikata\ClientApp\src\app\globalFrontendComponents\TitleBar\TitleBar.component.html", "HTML", 19, 0, 0, 0, 1, 1, 21
"c:\Users\44421\Desktop\sveikataAPI-master\sveikata\ClientApp\src\app\globalFrontendComponents\TitleBar\TitleBar.component.scss", "SCSS", 0, 0, 0, 13, 0, 1, 14
"c:\Users\44421\Desktop\sveikataAPI-master\sveikata\ClientApp\src\app\globalFrontendComponents\TitleBar\TitleBar.component.ts", "TypeScript", 0, 20, 0, 0, 0, 8, 28
"c:\Users\44421\Desktop\sveikataAPI-master\sveikata\ClientApp\src\app\globalFrontendComponents\global.module.ts", "TypeScript", 0, 49, 0, 0, 0, 5, 54
"c:\Users\44421\Desktop\sveikataAPI-master\sveikata\ClientApp\src\app\helpers\jwt.interceptor.ts", "TypeScript", 0, 18, 0, 0, 1, 3, 22
"c:\Users\44421\Desktop\sveikataAPI-master\sveikata\ClientApp\src\app\layouts\adminPanel\AdminPanelLayout.component.html", "HTML", 8, 0, 0, 0, 3, 0, 11
"c:\Users\44421\Desktop\sveikataAPI-master\sveikata\ClientApp\src\app\layouts\adminPanel\AdminPanelLayout.component.ts", "TypeScript", 0, 7, 0, 0, 0, 2, 9
"c:\Users\44421\Desktop\sveikataAPI-master\sveikata\ClientApp\src\app\layouts\auth\auth-layout.component.html", "HTML", 1, 0, 0, 0, 0, 0, 1
"c:\Users\44421\Desktop\sveikataAPI-master\sveikata\ClientApp\src\app\layouts\auth\auth-layout.component.ts", "TypeScript", 0, 7, 0, 0, 0, 2, 9
"c:\Users\44421\Desktop\sveikataAPI-master\sveikata\ClientApp\src\app\layouts\frontendPanel\FrontendPanel.component.html", "HTML", 6, 0, 0, 0, 4, 9, 19
"c:\Users\44421\Desktop\sveikataAPI-master\sveikata\ClientApp\src\app\layouts\frontendPanel\FrontendPanel.component.ts", "TypeScript", 0, 70, 0, 0, 6, 12, 88
"c:\Users\44421\Desktop\sveikataAPI-master\sveikata\ClientApp\src\app\plans\PlansDetail\PlansDetail.component.html", "HTML", 76, 0, 0, 0, 1, 4, 81
"c:\Users\44421\Desktop\sveikataAPI-master\sveikata\ClientApp\src\app\plans\PlansDetail\PlansDetail.component.scss", "SCSS", 0, 0, 0, 66, 11, 12, 89
"c:\Users\44421\Desktop\sveikataAPI-master\sveikata\ClientApp\src\app\plans\PlansDetail\PlansDetail.component.ts", "TypeScript", 0, 73, 0, 0, 0, 9, 82
"c:\Users\44421\Desktop\sveikataAPI-master\sveikata\ClientApp\src\app\plans\PlansGrid\PlansGrid.component.html", "HTML", 68, 0, 0, 0, 9, 2, 79
"c:\Users\44421\Desktop\sveikataAPI-master\sveikata\ClientApp\src\app\plans\PlansGrid\PlansGrid.component.scss", "SCSS", 0, 0, 0, 13, 0, 1, 14
"c:\Users\44421\Desktop\sveikataAPI-master\sveikata\ClientApp\src\app\plans\PlansGrid\PlansGrid.component.ts", "TypeScript", 0, 41, 0, 0, 0, 5, 46
"c:\Users\44421\Desktop\sveikataAPI-master\sveikata\ClientApp\src\app\plans\PlansList\PlansList.component.html", "HTML", 66, 0, 0, 0, 11, 2, 79
"c:\Users\44421\Desktop\sveikataAPI-master\sveikata\ClientApp\src\app\plans\PlansList\PlansList.component.scss", "SCSS", 0, 0, 0, 13, 0, 1, 14
"c:\Users\44421\Desktop\sveikataAPI-master\sveikata\ClientApp\src\app\plans\PlansList\PlansList.component.ts", "TypeScript", 0, 41, 0, 0, 0, 4, 45
"c:\Users\44421\Desktop\sveikataAPI-master\sveikata\ClientApp\src\app\plans\SidebarLayout\SidebarLayout.component.html", "HTML", 56, 0, 0, 0, 2, 2, 60
"c:\Users\44421\Desktop\sveikataAPI-master\sveikata\ClientApp\src\app\plans\SidebarLayout\SidebarLayout.component.scss", "SCSS", 0, 0, 0, 13, 0, 1, 14
"c:\Users\44421\Desktop\sveikataAPI-master\sveikata\ClientApp\src\app\plans\SidebarLayout\SidebarLayout.component.ts", "TypeScript", 0, 77, 0, 0, 0, 16, 93
"c:\Users\44421\Desktop\sveikataAPI-master\sveikata\ClientApp\src\app\plans\plans.module.ts", "TypeScript", 0, 39, 0, 0, 0, 4, 43
"c:\Users\44421\Desktop\sveikataAPI-master\sveikata\ClientApp\src\app\plans\plans.routing.ts", "TypeScript", 0, 29, 0, 0, 0, 2, 31
"c:\Users\44421\Desktop\sveikataAPI-master\sveikata\ClientApp\src\app\services\authentication.service.ts", "TypeScript", 0, 46, 0, 0, 2, 7, 55
"c:\Users\44421\Desktop\sveikataAPI-master\sveikata\ClientApp\src\app\services\comment.service.ts", "TypeScript", 0, 48, 0, 0, 3, 15, 66
"c:\Users\44421\Desktop\sveikataAPI-master\sveikata\ClientApp\src\app\services\exercise.service.ts", "TypeScript", 0, 36, 0, 0, 0, 13, 49
"c:\Users\44421\Desktop\sveikataAPI-master\sveikata\ClientApp\src\app\services\message.service.ts", "TypeScript", 0, 33, 0, 0, 0, 10, 43
"c:\Users\44421\Desktop\sveikataAPI-master\sveikata\ClientApp\src\app\services\plan.service.ts", "TypeScript", 0, 60, 0, 0, 0, 21, 81
"c:\Users\44421\Desktop\sveikataAPI-master\sveikata\ClientApp\src\app\services\post.service.ts", "TypeScript", 0, 29, 0, 0, 0, 9, 38
"c:\Users\44421\Desktop\sveikataAPI-master\sveikata\ClientApp\src\app\services\review.service.ts", "TypeScript", 0, 46, 0, 0, 0, 14, 60
"c:\Users\44421\Desktop\sveikataAPI-master\sveikata\ClientApp\src\app\services\user.service.ts", "TypeScript", 0, 52, 0, 0, 0, 17, 69
"c:\Users\44421\Desktop\sveikataAPI-master\sveikata\ClientApp\src\app\session\ComingSoon\ComingSoon.component.html", "HTML", 20, 0, 0, 0, 4, 2, 26
"c:\Users\44421\Desktop\sveikataAPI-master\sveikata\ClientApp\src\app\session\ComingSoon\ComingSoon.component.scss", "SCSS", 0, 0, 0, 13, 0, 1, 14
"c:\Users\44421\Desktop\sveikataAPI-master\sveikata\ClientApp\src\app\session\ComingSoon\ComingSoon.component.ts", "TypeScript", 0, 24, 0, 0, 0, 5, 29
"c:\Users\44421\Desktop\sveikataAPI-master\sveikata\ClientApp\src\app\session\ForgotPassword\ForgotPassword.component.html", "HTML", 45, 0, 0, 0, 0, 4, 49
"c:\Users\44421\Desktop\sveikataAPI-master\sveikata\ClientApp\src\app\session\ForgotPassword\ForgotPassword.component.scss", "SCSS", 0, 0, 0, 13, 0, 1, 14
"c:\Users\44421\Desktop\sveikataAPI-master\sveikata\ClientApp\src\app\session\ForgotPassword\ForgotPassword.component.ts", "TypeScript", 0, 14, 0, 0, 0, 6, 20
"c:\Users\44421\Desktop\sveikataAPI-master\sveikata\ClientApp\src\app\session\Login\Login.component.html", "HTML", 60, 0, 0, 0, 0, 0, 60
"c:\Users\44421\Desktop\sveikataAPI-master\sveikata\ClientApp\src\app\session\Login\Login.component.scss", "SCSS", 0, 0, 0, 13, 0, 1, 14
"c:\Users\44421\Desktop\sveikataAPI-master\sveikata\ClientApp\src\app\session\Login\Login.component.ts", "TypeScript", 0, 58, 0, 0, 1, 10, 69
"c:\Users\44421\Desktop\sveikataAPI-master\sveikata\ClientApp\src\app\session\SignUp\SignUp.component.html", "HTML", 72, 0, 0, 0, 0, 2, 74
"c:\Users\44421\Desktop\sveikataAPI-master\sveikata\ClientApp\src\app\session\SignUp\SignUp.component.scss", "SCSS", 0, 0, 0, 13, 0, 1, 14
"c:\Users\44421\Desktop\sveikataAPI-master\sveikata\ClientApp\src\app\session\SignUp\SignUp.component.ts", "TypeScript", 0, 46, 0, 0, 0, 8, 54
"c:\Users\44421\Desktop\sveikataAPI-master\sveikata\ClientApp\src\app\session\session.module.ts", "TypeScript", 0, 24, 0, 0, 0, 5, 29
"c:\Users\44421\Desktop\sveikataAPI-master\sveikata\ClientApp\src\app\session\session.routing.ts", "TypeScript", 0, 25, 0, 0, 0, 3, 28
"Total", "-", 1493, 2797, 0, 562, 260, 667, 5779